You slowly peel your eyes open to be met by the blinding midday light. The bones in your back crackle and pop as you attempt to sit up. It takes you a moment to orient yourself in this unfamiliar enviorment. It's time to find out what you've missed.

WakeyWakey
An Interactive Fiction by Riley Kam
Release 1 / Serial number 141007 / Inform 7 build 6L38 (I6/v6.33 lib 6/12N) SD

Bedroom
A nice comfy bedroom with a nice skylight sitting directly over the bed. A pile of dirty clothes lay clumped in a pile on the floor. A lone dresser with a mirror resides across from the bed. To the east is the Study. To the south is the kitchen.

You can see a velvet door here.

>get all
pills: Taken.

>e
Study
 A dark work room, its only lights eminate from the desktop compter and the small graphing desk. A large full length file cabinet rest in the corner. To the west is the Bedroom

You can see an I Suck here.

>get all
I Suck: Taken.

* * *

>take pills
Taken.

>eat pills
Right as your about to take these you realize you probably have more important issues to attend to and that if you take these again you'll probably never wake up again. Instead you crush the pills.

>i
You are carrying:
  a pills

>take pills
You already have that.

>eat pills
Right as your about to take these you realize you probably have more important issues to attend to and that if you take these again you'll probably never wake up again. Instead you crush the pills.

* * *

>e
Study
 A dark work room, its only lights eminate from the desktop compter and the small graphing desk. A large full length file cabinet rest in the corner. To the west is the Bedroom

>open cabinet with key
You can't see any such thing.

>open cabinet with i suck
(first taking the I Suck)
You unlock the file cabinet.

>open cabinet
You open the file cabinet, revealing a key.

>take key
Taken.

>take dirty clothes
You can't see any such thing.

>w
Bedroom
A nice comfy bedroom with a nice skylight sitting directly over the bed. A pile of dirty clothes lay clumped in a pile on the floor. A lone dresser with a mirror resides across from the bed. To the east is the Study. To the south is the kitchen.

You can see a velvet door here.

>take dirty clothes
Taken.

>open velvet door with key
You unlock the velvet door.

>combine puddle with dirty clothes
You can't see any such thing.

>combine puddle with dirty clothers
You can't see any such thing.

>s
(first opening the velvet door)

Kitchen room
 What remains of this modest kitchen is what appears to be a war zone. It seems as though little Sally went on a rampage. There is a large white freezer plugged in right next to the sink. A puddle . What seems to be a kitchenware drawer is open. To the North is the Bedroom, to the South is Sally's Room. 

You can see a velvet door and a flower door here.

>combine puddle with dirty clothes
By adding the dirty clothes to the puddle you soaked up the puddle leaving you with some soaked clothes.

>i
You are carrying:
  Soaked clothes
  a key
  an I Suck

>s
(first opening the flower door)
 You cannot leave without cleaning this up.

* * *

>e
Study
 A dark work room, its only lights eminate from the desktop compter and the small graphing desk. A large full length file cabinet rest in the corner. To the west is the Bedroom

>open cabinet with i suck
(first taking the I Suck)
You unlock the file cabinet.

* * *

>take key
Taken.

>w
Bedroom
A nice comfy bedroom with a nice skylight sitting directly over the bed. A pile of dirty clothes lay clumped in a pile on the floor. A lone dresser with a mirror resides across from the bed. To the east is the Study. To the south is the kitchen.

You can see a velvet door here.

>open velvet door
It seems to be locked.

>open velvet door with key
You unlock the velvet door.

>take clothes
Taken.

>s
(first opening the velvet door)

Kitchen room
 What remains of this modest kitchen is what appears to be a war zone. It seems as though little Sally went on a rampage. There is a large white freezer plugged in right next to the sink. What seems to be a kitchenware drawer is open. To the North is the Bedroom, to the South is Sally's Room.  

You can see a velvet door here.

>s
Sally's Room
The Room is reminiscent of your sister's room back when you were kids. There is a large glass window framed above a small pink bed. The smell of rotten flesh emanates from the easy bake oven. The Kitchen is North.

>n
Kitchen room
 What remains of this modest kitchen is what appears to be a war zone. It seems as though little Sally went on a rampage. There is a large white freezer plugged in right next to the sink. What seems to be a kitchenware drawer is open. To the North is the Bedroom, to the South is Sally's Room.  

You can see a velvet door here.

* * *

>w
Bedroom
A nice comfy bedroom with a nice skylight sitting directly over the bed. A pile of dirty clothes lay clumped in a pile on the floor. A lone dresser with a mirror resides across from the bed. To the east is the Study. To the south is the kitchen.

You can see a velvet door here.

>take clothes
Taken.

>open velvet door with key
You unlock the velvet door.

>s
(first opening the velvet door)

Kitchen room
 What remains of this modest kitchen is what appears to be a war zone. It seems as though little Sally went on a rampage. There is a large white freezer plugged in right next to the sink. A puddle . What seems to be a kitchenware drawer is open. To the North is the Bedroom, to the South is Sally's Room. 

You can see a velvet door and a flower door here.

>s
(first opening the flower door)
Kitchen room
 What remains of this modest kitchen is what appears to be a war zone. It seems as though little Sally went on a rampage. There is a large white freezer plugged in right next to the sink. A puddle . What seems to be a kitchenware drawer is open. To the North is the Bedroom, to the South is Sally's Room. 

You can see a velvet door and a flower door here.

 You cannot leave without cleaning this up.

>s
(first opening the flower door)
Kitchen room
 What remains of this modest kitchen is what appears to be a war zone. It seems as though little Sally went on a rampage. There is a large white freezer plugged in right next to the sink. A puddle . What seems to be a kitchenware drawer is open. To the North is the Bedroom, to the South is Sally's Room. 

You can see a velvet door and a flower door here.

 You cannot leave without cleaning this up.

>combine clothes with puddle
You can't see any such thing.

>combine dirty clothers with puddle
You can't see any such thing.

>n
Bedroom
A nice comfy bedroom with a nice skylight sitting directly over the bed. A pile of dirty clothes lay clumped in a pile on the floor. A lone dresser with a mirror resides across from the bed. To the east is the Study. To the south is the kitchen.

You can see a velvet door here.

>s
Kitchen room
 What remains of this modest kitchen is what appears to be a war zone. It seems as though little Sally went on a rampage. There is a large white freezer plugged in right next to the sink. A puddle . What seems to be a kitchenware drawer is open. To the North is the Bedroom, to the South is Sally's Room. 

You can see a velvet door and a flower door here.

>i
You are carrying:
  a dirty clothes
  a key
  an I Suck

>combine puddle with dirty clothes
By adding the dirty clothes to the puddle you soaked up the puddle leaving you with some soaked clothes.

* * *

>s
(first opening the flower door)
 You cannot leave without cleaning this up.

>s
(first opening the flower door)
 You cannot leave without cleaning this up.

>i
You are carrying:
  Soaked clothes
  a key
  an I Suck

* * *

>w
Bedroom
A nice comfy bedroom with a nice skylight sitting directly over the bed. A pile of dirty clothes lay clumped in a pile on the floor. A lone dresser with a mirror resides across from the bed. To the east is the Study. To the south is the kitchen.

You can see a velvet door here.

>open velvet door with key
You unlock the velvet door.

>take dirty clothes
Taken.

>s
(first opening the velvet door)

Kitchen room
 What remains of this modest kitchen is what appears to be a war zone. It seems as though little Sally went on a rampage. There is a large white freezer plugged in right next to the sink. A puddle . What seems to be a kitchenware drawer is open. To the North is the Bedroom, to the South is Sally's Room. 

You can see a velvet door and a flower door here.

>combine dirty clothes with puddle
You can't see any such thing.

>combine puddle with dirty clothes
By adding the dirty clothes to the puddle you soaked up the puddle leaving you with some soaked clothes.

>s
(first opening the flower door)
 You cannot leave without cleaning this up.

* * *

>open cabinet with i suck
(first taking the I Suck)
You unlock the file cabinet.

>key
That's not a verb I recognise.

>open cabinet
You open the file cabinet, revealing a key.

* * *

>w
Bedroom
A nice comfy bedroom with a nice skylight sitting directly over the bed. A pile of dirty clothes lay clumped in a pile on the floor. A lone dresser with a mirror resides across from the bed. To the east is the Study. To the south is the kitchen.

You can see a velvet door here.

>take clothers
You can't see any such thing.

>take clothes
Taken.

>oen velvet door with key
That's not a verb I recognise.

>open velvet door with key
You unlock the velvet door.

* * *

>s
(first opening the flower door)
Kitchen room
 What remains of this modest kitchen is what appears to be a war zone. It seems as though little Sally went on a rampage. There is a large white freezer plugged in right next to the sink. A puddle . What seems to be a kitchenware drawer is open. To the North is the Bedroom, to the South is Sally's Room. 

You can see a velvet door and a flower door here.

 You cannot leave without cleaning this up.

>combine puddle with dirty clothes
By adding the dirty clothes to the puddle you soaked up the puddle leaving you with some soaked clothes.

* * *

>e
Study
 A dark work room, its only lights eminate from the desktop compter and the small graphing desk. A large full length file cabinet rest in the corner. To the west is the Bedroom

>open cabinet with I suck
(first taking the I Suck)
You unlock the file cabinet.

>open cabinet
You open the file cabinet, revealing a key.

* * *

>take key
Taken.

>e
You can't go that way.

>w
Bedroom
A nice comfy bedroom with a nice skylight sitting directly over the bed. A pile of dirty clothes lay clumped in a pile on the floor. A lone dresser with a mirror resides across from the bed. To the east is the Study. To the south is the kitchen.

You can see a velvet door here.

* * *

>take clothes
Taken.

>s
(first opening the velvet door)
It seems to be locked.

>open velvet door with key
You unlock the velvet door.

>s
(first opening the velvet door)

Kitchen room
 What remains of this modest kitchen is what appears to be a war zone. It seems as though little Sally went on a rampage. There is a large white freezer plugged in right next to the sink. What seems to be a kitchenware drawer is open. To the North is the Bedroom, to the South is Sally's Room.  

You can see a velvet door here.

* * *

>x velvet door
A large Koa door with a wiki tiki on its handle.

>x dresser
This Old Dresser  has seen quite a bit of wear and tear. There is limited counter space that has a few uselesss cosmetics. A large mirror is embedded in the dresser, you could probably use it to see yourself.

>x mirror
 When you look into the mirror you see your reflection. You look awful, your hair is tangled and mangled. There are deep, dark bags that sag from under your eyes. Your dilapidated state reminds you that last night was terrible. The reason still escapes you but you remember something about the bed...

>x bed
 After closer examination, you wonder why you even bothered to look at this bed. it's just a Bed. However, there seems to be small pills on its cover.

In the Bed is a pills.

>x pills
These seems to be over-the-counter deep sleep pills. A couple of these could probably knock out an elephant, its amazing you're awake. Don't even try to take these again.

>take pills
Taken.

>i
You are carrying:
  a pills

>l
Bedroom
A nice comfy bedroom with a nice skylight sitting directly over the bed. A pile of dirty clothes lay clumped in a pile on the floor. A lone dresser with a mirror resides across from the bed. To the east is the Study. To the south is the kitchen.

You can see a velvet door here.

>x clothes
A gigantic pile of your dirty clothes that have been fermenting for a while. Last night they got even worse when you spilt coke by them and they absorbed it .

>take clothes
Taken.

>l
Bedroom
A nice comfy bedroom with a nice skylight sitting directly over the bed. A pile of dirty clothes lay clumped in a pile on the floor. A lone dresser with a mirror resides across from the bed. To the east is the Study. To the south is the kitchen.

You can see a velvet door here.

>look under clothes
You find nothing of interest.

>x skylight
 Like a light house piercing the viel of your memory this glass pane has awoken you from your drug induced slumber.

>open dresser
It isn't something you can open.

>l
Bedroom
A nice comfy bedroom with a nice skylight sitting directly over the bed. A pile of dirty clothes lay clumped in a pile on the floor. A lone dresser with a mirror resides across from the bed. To the east is the Study. To the south is the kitchen.

You can see a velvet door here.

>e
Study
 A dark work room, its only lights eminate from the desktop compter and the small graphing desk. A large full length file cabinet rest in the corner. To the west is the Bedroom

>x cabinet
 A high tech file cabinet that is in the shape of a businessman. Your sister buys the weirdest things. A small screen asks for a password.

>x screen
You can't see any such thing.

>x computer
 A new Mac desktop still turned on with muiltiple applications opened. On the Web Browser is an open email account belonging to your sister. One email appears to be starred.

>x desk
 As you look at the desk you at first only notice the massive clutter of paper. Right as you're turning away you notice a bright green note on the desk.

>x note
 The note appears to be from your sister addressed to you. It reads, Hey Bro, I need you to watch my daughter Sally for a couple days while me and Jim are on our honeymoon. I know she'll probably drive you crazy but bear with it. Don't take sleep pills just to escape the stress of dealing with her. She's quite a lively one so if you leave her alone she may mess with you and our precious house. Thanks for the Solid and see you soon. -From, Ann P.S If you do pass out and are reading this message for the first time, (to your knowledge), open the file cabinet with, I Suck, as the password

>x email
 The email reads about your sister's love life. A saucy email exchanged between her and her husband, apparently before they got married. You realize that you are 40 years old, lonely and working as a professional pooper scooper.

>x cabinet
 A high tech file cabinet that is in the shape of a businessman. Your sister buys the weirdest things. A small screen asks for a password.

* * *

>x screen
You can't see any such thing.

>x password
You can't see any such thing.

>I Suck
I only understood you as far as wanting to take inventory.

>open cabinet
It seems to be locked.

>open cabinet with I Suck
(first taking the I Suck)
You unlock the file cabinet.

>open file cabinet
You open the file cabinet, revealing a key.

>x key
 An iron key with a small velvet strip taped to the top.

>take key
Taken.

>x key
 An iron key with a small velvet strip taped to the top.

>l
Study
 A dark work room, its only lights eminate from the desktop compter and the small graphing desk. A large full length file cabinet rest in the corner. To the west is the Bedroom

>w
Bedroom
A nice comfy bedroom with a nice skylight sitting directly over the bed. A pile of dirty clothes lay clumped in a pile on the floor. A lone dresser with a mirror resides across from the bed. To the east is the Study. To the south is the kitchen.

You can see a velvet door here.

>s
(first opening the velvet door)
It seems to be locked.

>unlock door with key
You unlock the velvet door.

>s
(first opening the velvet door)

Kitchen room
 What remains of this modest kitchen is what appears to be a war zone. It seems as though little Sally went on a rampage. There is a large white freezer plugged in right next to the sink. A puddle . What seems to be a kitchenware drawer is open. To the North is the Bedroom, to the South is Sally's Room. 

You can see a velvet door and a flower door here.

>x freezer
You can't see any such thing.

>x refridgerator
You can't see any such thing.

>x refridgerator
You can't see any such thing.

>x puddle
This large puzzle of water probably formed from the water pouring out from the sink. If you don't clean this up then when your sister comes home she could slip and fall. Combining something absorbant with this would probably get the mess cleaned up.

>x drawer
 The drawer's contents consist of utensils and oven mitts. There is a slot in the drawer that belonged to a long butcher knife however it's empty... Either she's dead or you are.

>x utensils
You can't see any such thing.

>l
Kitchen room
 What remains of this modest kitchen is what appears to be a war zone. It seems as though little Sally went on a rampage. There is a large white freezer plugged in right next to the sink. A puddle . What seems to be a kitchenware drawer is open. To the North is the Bedroom, to the South is Sally's Room. 

You can see a velvet door and a flower door here.

>n
Bedroom
A nice comfy bedroom with a nice skylight sitting directly over the bed. A pile of dirty clothes lay clumped in a pile on the floor. A lone dresser with a mirror resides across from the bed. To the east is the Study. To the south is the kitchen.

You can see a velvet door here.

* * *

>s
Kitchen room
 What remains of this modest kitchen is what appears to be a war zone. It seems as though little Sally went on a rampage. There is a large white freezer plugged in right next to the sink. A puddle . What seems to be a kitchenware drawer is open. To the North is the Bedroom, to the South is Sally's Room. 

You can see a velvet door and a flower door here.

>put clothes on puddle
Putting things on the puddle would achieve nothing.

>combine clothes on puddle
You can't see any such thing.

>i
You are carrying:
  a key
  an I Suck
  a dirty clothes
  a pills

>x I suck
 A small password for a small man.

>combine dirty clothes with puddle
By adding the dirty clothes to the puddle you soaked up the puddle leaving you with some soaked clothes.

>l
Kitchen room
 What remains of this modest kitchen is what appears to be a war zone. It seems as though little Sally went on a rampage. There is a large white freezer plugged in right next to the sink. A puddle . What seems to be a kitchenware drawer is open. To the North is the Bedroom, to the South is Sally's Room. 

You can see a velvet door and a flower door here.

>s
(first opening the flower door)
 You cannot leave without cleaning this up.

sally's room
The Room is reminiscent of your sister's room back when you were kids. There is a large glass window framed above a small pink bed. The smell of rotten flesh emanates from the easy bake oven. The Kitchen is North.

You can see a flower door here.

>x window
    ***  Air gushes through the open window. It seems as though Sally has escaped and is living in the wild. Outside you can hear your sisters car pull into the driveway... You'll be with God soon. ***

Would you like to RESTART, RESTORE a saved game, QUIT or UNDO the last command?

* * *

>w
You can't go that way.

>e
Study
 A dark work room, its only lights eminate from the desktop compter and the small graphing desk. A large full length file cabinet rest in the corner. To the west is the Bedroom

* * *

>s
(first opening the velvet door)
It seems to be locked.

>n
(first opening the Velvet Door)
It seems to be locked.

>take password
Taken.

>open file cabinet with password
You unlock the file cabinet.

>open cabinet
You open the file cabinet, revealing a key.

>take ke
You can't see any such thing.

>take key
Taken.

>open velvet door
It seems to be locked.

>open velvet door with key
You unlock the Velvet Door.

* * *

>s
(first opening the velvet door)
It seems to be locked.

>e
Study
 A dark work room, its only lights eminate from the desktop compter and the small graphing desk. A large full length file cabinet rest in the corner. To the west is the Bedroom

>take password
Taken.

>open the file cabinet with password
That doesn't seem to fit the lock.

>open file cabinet with password
That doesn't seem to fit the lock.

>open file cabinet with the password
That doesn't seem to fit the lock.

>open file cabinet with password
That doesn't seem to fit the lock.

>i
You are carrying:
  a password

>look at file cabinet
 A high tech file cabinet that is in the shape of a buisness man. Your sister buys the wierdest things. A small screen ask for a password.

>l
Study
 A dark work room, its only lights eminate from the desktop compter and the small graphing desk. A large full legnth file cabinet rest in the corner. To the west is the Bedroom

>x cabinet
 A high tech file cabinet that is in the shape of a buisness man. Your sister buys the wierdest things. A small screen ask for a password.

* * *

>e
Study
 A dark work room, its only lights eminate from the desktop compter and the small graphing desk. A large full length file cabinet rest in the corner. To the west is the Bedroom

>take isuck
You can't see any such thing.

>open cabinet with I suck
(first taking the I Suck)
You unlock the file cabinet.

* * *

>s
(first opening the velvet door)
It seems to be locked.

>open vvelvet door with key
You can't see any such thing.

>open velvet door with key
You unlock the velvet door.

* * *

>s
Sally's Room
The Room is reminiscent of your sister's room back when you were kids. There is a large glass window framed above a small pink bed. The smell of rotten flesh emanates from the easy bake oven. The Kitchen is North.

>x window
    ***  Air gushes through the open window. It seems as though Sally has escaped and is living in the wild. You'll be with God soon. ***

Would you like to RESTART, RESTORE a saved game, QUIT or UNDO the last command?

* * *

>e
Study
 A dark work room, its only lights eminate from the desktop compter and the small graphing desk. A large full length file cabinet rest in the corner. To the west is the Bedroom

>take I suck
Taken.

>open cabinet with I suck
You unlock the file cabinet.

>open cabinet
You open the file cabinet, revealing a key.

* * *

>s
(first opening the velvet door)

Kitchen room
 What remains of this modest kitchen is what appears to be a war zone. It seems as though little Sally went on a rampage. There is a large white freezer plugged in right next to the sink. What seems to be a kitchenware drawer is open. To the North is the Bedroom, to the South is Sally's Room.  

You can see a velvet door here.

>s
Sally's Room
The Room is reminiscent of your sister's room back when you were kids. There is a large glass window framed above a small pink bed. The smell of rotten flesh emanates from the easy bake oven. The Kitchen is North and the Yard is towards the South.

>x windown
You can't see any such thing.

>x window
    *** The End ***

Would you like to RESTART, RESTORE a saved game, QUIT or UNDO the last command?

* * *

>combine puddle with dirty clothes
By adding the dirty clothes to the puddle you soaked up the puddle leaving you with some soaked clothes.

>s
(first opening the flower door)
 You cannot leave without cleaning this up.

sally's room
The Room is reminiscent of your sister's room back when you were kids. There is a large glass window framed above a small pink bed. The smell of rotten flesh emanates from the easy bake oven. The Kitchen is North.

You can see a flower door here.

>n
(first opening the flower door)
 You cannot leave without cleaning this up.

sally's room
The Room is reminiscent of your sister's room back when you were kids. There is a large glass window framed above a small pink bed. The smell of rotten flesh emanates from the easy bake oven. The Kitchen is North.

You can see a flower door here.

>n
(first opening the flower door)
 You cannot leave without cleaning this up.

sally's room
The Room is reminiscent of your sister's room back when you were kids. There is a large glass window framed above a small pink bed. The smell of rotten flesh emanates from the easy bake oven. The Kitchen is North.

You can see a flower door here.

* * *

>x skylight
 Like a light house piercing the viel of your memory this glass pane has awoken you from your drug induced slumber.

>bed
That's not a verb I recognise.

>x bed
 After closer examination, you wonder why you even bothered to look at this bed. it's just a Bed. However, there seems to be small pills on its cover.

In the Bed is a pills.

>x pills
These seems to be over-the-counter deep sleep pills. A couple of these could probably knock out an elephant, its amazing you're awake.

>take pills
Taken.

>eat pills
That's plainly inedible.

>x clothes
A gigantic pile of your dirty clothes that have been fermenting for a while. Use these to stoke the flames of Hell.

>take clothes
That's hardly portable.

>take clothe
You can't see any such thing.

>take pile of clothes
You can't see any such thing.

>x dresser
This Old Dresser  has seen quite a bit of wear and tear. There is limited counter space that has a few uselesss cosmetics. A large mirror is embedded in the dresser, you could probably use it to see yourself.

>l
Bedroom
A nice comfy bedroom with a nice skylight sitting directly over the bed. A pile of dirty clothes lay clumped in a pile on the floor. A lone dresser with a mirror resides across from the bed. To the east is the Study. To the south is the kitchen.

You can see a velvet door here.

>x cosmetics
You can't see any such thing.

>x mirror
 When you look into the mirror you see your reflection. You look awful, your hair is tangled and mangled. There are deep, dark bags that sag from under your eyes. Your dilapidated state reminds you that last night was terrible. The reason still escapes you but you remember something about the bed...

>e
Study
 A dark work room, its only lights eminate from the desktop compter and the small graphing desk. A large full length file cabinet rest in the corner. To the west is the Bedroom

>x desk
 As you look at the desk you at first only notice the massive clutter of paper. Right as you're turning away you notice a bright green note on the desk.

>x computer
 A new Mac desktop still turned on with muiltiple applications opened. On the Web Browser is an open email account belonging to your sister. One email appears to be starred.

>x email
 The email reads about your sister's love life. A saucy email exchanged between her and her husband, apparently before they got married. You realize that you are 40 years old, lonely and working as a professional pooper scooper.

>x paper
You can't see any such thing.

>x note
 The note appears to be from your sister addressed to you. It reads, Hey Bro, I need you to watch my daughter Sally for a couple days while me and Jim are on our honeymoon. I know she'll probably drive you crazy but bear with it. Don't take sleep pills just to escape the stress of dealing with her. She's quite a lively one so if you leave her alone she may mess with you and our precious house. Thanks for the Solid and see you soon. -From, Ann P.S If you do pass out and are reading this message for the first time, (to your knowledge), then go to the file cabinet and open it using, I Suck, as the password

>x cabinet
 A high tech file cabinet that is in the shape of a businessman. Your sister buys the weirdest things. A small screen asks for a password.

>enter I Suck
You can't see any such thing.

>say I Suck
(to yourself)
There is no reply.

>write I Suck
That's not a verb I recognise.

>x screen
You can't see any such thing.

>enter I Suck on screen
You can't see any such thing.

>type I Suck on screen
That's not a verb I recognise.

>write I Suck on screen
That's not a verb I recognise.

>say I Suck to screen
You can't see any such thing.

>say I Suck to cabinet
You can only do that to something animate.

>I Suck
I only understood you as far as wanting to take inventory.

>i
You are carrying:
  a pills

* * *

>take pills
You already have that.

>eat pills
That's plainly inedible.

>enter password
You can't see any such thing.

>open cabinet
It seems to be locked.

>unlock cabinet
(with the pills)
That doesn't seem to fit the lock.

>punch in I Suck
I only understood you as far as wanting to punch inside.

>put in I Suck
I didn't understand that sentence.

>enter I Suck
You can't see any such thing.

>enter I Suck on screen
You can't see any such thing.

>enter I Suck on keyboard
You can't see any such thing.

>l
Study
 A dark work room, its only lights eminate from the desktop compter and the small graphing desk. A large full length file cabinet rest in the corner. To the west is the Bedroom

>x cabinet
 A high tech file cabinet that is in the shape of a businessman. Your sister buys the weirdest things. A small screen asks for a password.

>open cabinet
It seems to be locked.

>x screen
You can't see any such thing.

>x small screen
You can't see any such thing.

>x password
You can't see any such thing.

>take I Suck
You can't see any such thing.

>x note
 The note appears to be from your sister addressed to you. It reads, Hey Bro, I need you to watch my daughter Sally for a couple days while me and Jim are on our honeymoon. I know she'll probably drive you crazy but bear with it. Don't take sleep pills just to escape the stress of dealing with her. She's quite a lively one so if you leave her alone she may mess with you and our precious house. Thanks for the Solid and see you soon. -From, Ann P.S If you do pass out and are reading this message for the first time, (to your knowledge), then go to the file cabinet and open it using, I Suck, as the password

>take I Suck
You can't see any such thing.

>take password
You can't see any such thing.

>take I Suck
You can't see any such thing.

>open cabinet with I Suck
You can't see any such thing.

>x cabinet
 A high tech file cabinet that is in the shape of a businessman. Your sister buys the weirdest things. A small screen asks for a password.

>open cabinet with I Suck
You can't see any such thing.

>open cabinet with i suck
You can't see any such thing.

>e
You can't go that way.

>e
You can't go that way.

* * *

>w
Bedroom
A nice comfy bedroom with a nice skylight sitting directly over the bed. A pile of dirty clothes lay clumped in a pile on the floor. A lone dresser with a mirror resides across from the bed. To the east is the Study. To the south is the kitchen.

You can see a velvet door here.

>e
Study
 A dark work room, its only lights eminate from the desktop compter and the small graphing desk. A large full length file cabinet rest in the corner. To the west is the Bedroom

>i
You are carrying:
  a pills