 You slowly peel your eyes open to be met by the blinding mid day light. The bones in your back crackle and pop as you attempt to sit up. It takes you a moment to orient yourself in this unfamiliar enviorment. It's time to find out what you've missed.

WakeyWakey
An Interactive Fiction by Riley Kam
Release 1 / Serial number 141001 / Inform 7 build 6L38 (I6/v6.33 lib 6/12N) SD

Bedroom
A nice comfy bedroom with a nice skylight sitting directly over the bed. A pile of dirty clothes lay clumped in a pile on the floor. A lone dresser with a mirror resides across from the bed. To the east is the Study. To the south is the kitchen.

You can see a key here.

>x take dirty clothes
You can't see any such thing.

>take dirty clothes
That's hardly portable.

>x dirty clothes
A gigantic pile of your dirty clothes that have been fermenting for a while. Although they smell terrible they are still quite soft and absorbant...

>take
What do you want to take?

>take dirty clothes
That's hardly portable.

* * *

>take dirty clothes
That's hardly portable.

* * *

>x dirty clothes
A gigantic pile of your dirty clothes that have been fermenting for a while. Although they smell terrible they are still quite soft and absorbant...

* * *

>x bed
You can't see any such thing.

>x clothes
A gigantic pile of your dirty clothes that have been fermenting for a while. Although they smell terrible they are still quite soft and absorbant...

>take clothes
That's hardly portable.

>move clothes
You are unable to.

>why not
That's not a verb I recognise.

>look under clothes
You find nothing of interest.

* * *

>take key
Taken.

* * *

>e
Study
 A dark work room, its only lights eminate from the desktop compter and the small graphing desk. A large full legnth file cabinet rest in the corner. To the west is the Bedroom

>Say I suck
(to yourself)
There is no reply.

>Say I suck to the file cabinet
You can only do that to something animate.

* * *

>e
Study
 A dark work room, its only lights eminate from the desktop compter and the small graphing desk. A large full legnth file cabinet rest in the corner. To the west is the Bedroom

>x computer
 A new Mac desktop still turned on with muiltiple application opened. On the Web Browswer is an open email account belonging to your sister. One email appears to be starred.

>x email
 The email reads about your sister's love life. A saucy email exchanged between her and her husband, apparently before they got married. You realize that you are 40 years old, lonely and working as a proffessioner pooper scooper.

>x desk
 As you look at the desk you at first only notice the massive clutter of paper. Right as your turning away you notice a bright green sticky note on the desk.

>x note
 The note appears to be from your sister addressed to you. It reads, Hey Bro, I need you to watch my daughter Sally for a couple days while me and Jim are on our honeymoon. I know she'll probably drive you crazy but bear with it. Don't take sleep pills just to escape the stress of dealing with her. She's quite a lively one so if you leave her alone she may mess with you and our precious house. Thanks for the Solid and see you soon. -From, Ann P.S If you do pass out and are reading this message for the first time, (to your knowledge), then go to the file cabinet and say, I Suck

>x file cabinet
 A file cabinet that seems to contain important imformation. Currently it is locked.

>say I Suck
(to yourself)
There is no reply.

>I Suck
I only understood you as far as wanting to take inventory.

>Say I suck to the File cabinet
You can only do that to something animate.

* * *

>s
kitchen room
 What remains of this modest kitchen is what appears to be a war zone. It seems as though little Sally has went on a rampage. There is a large white freezer plugged in right next to the sink. What seems to be a kitchen ware drawer is open. To the North is the Bedroom, to the South is Sally's Room.  

You can see a Velvet Door here.

>n
(first opening the Velvet Door)
It seems to be locked.

>e
Study
 A dark work room, its only lights eminate from the desktop compter and the small graphing desk. A large full legnth file cabinet rest in the corner. To the west is the Bedroom

>say I Suck
(to yourself)
There is no reply.

>x cabinet
 A file cabinet that seems to contain important imformation. Currently it is locked.

>x
What do you want to examine?

>open cabinet
It seems to be locked.

* * *

>n
(first opening the Velvet Door)
It seems to be locked.

>fuck you
That's not a verb I recognise.

>damn it
That's not a verb I recognise.

>buf
That's not a verb I recognise.

I beg your pardon?

>as
That's not a verb I recognise.

I beg your pardon?

>d
You can't go that way.

>f
That's not a verb I recognise.

>f
That's not a verb I recognise.

I beg your pardon?

I beg your pardon?

* * *

>s
kitchen room
 What remains of this modest kitchen is what appears to be a war zone. It seems as though little Sally has went on a rampage. There is a large white freezer plugged in right next to the sink. What seems to be a kitchen ware drawer is open. To the North is the Bedroom, to the South is Sally's Room.  

You can see a Velvet Door here.

>e
You can't go that way.

>l
Example Location

* * *

>s
kitchen room
 What remains of this modest kitchen is what appears to be a war zone. It seems as though little Sally has went on a rampage. There is a large white freezer plugged in right next to the sink. What seems to be a kitchen ware drawer is open. To the North is the Bedroom, to the South is Sally's Room.  

You can see a Velvet Door here.

>s
Sally's Room
The Room is reminescent of your sister's room back when you were kids. There is a large glass window framed above a small pink bed. The smell of rotten flesh eminates from the easy back oven. The Kitchen is North and the Yard is towards the South.

>e
You can't go that way.

>n
kitchen room
 What remains of this modest kitchen is what appears to be a war zone. It seems as though little Sally has went on a rampage. There is a large white freezer plugged in right next to the sink. What seems to be a kitchen ware drawer is open. To the North is the Bedroom, to the South is Sally's Room.  

You can see a Velvet Door here.

>n
(first opening the Velvet Door)
It seems to be locked.

>n
(first opening the Velvet Door)
It seems to be locked.

>s
Sally's Room
The Room is reminescent of your sister's room back when you were kids. There is a large glass window framed above a small pink bed. The smell of rotten flesh eminates from the easy back oven. The Kitchen is North and the Yard is towards the South.

>n
kitchen room
 What remains of this modest kitchen is what appears to be a war zone. It seems as though little Sally has went on a rampage. There is a large white freezer plugged in right next to the sink. What seems to be a kitchen ware drawer is open. To the North is the Bedroom, to the South is Sally's Room.  

You can see a Velvet Door here.

* * *

>s
kitchen room
 What remains of this modest kitchen is what appears to be a war zone. It seems as though little Sally has went on a rampage. There is a large white freezer plugged in right next to the sink. What seems to be a kitchen ware drawer is open. To the North is the Bedroom, to the South is Sally's Room.  

You can see a Velvet Door here.

>I Suck
I only understood you as far as wanting to take inventory.

* * *

>say I suck to the cabinet
You can't see any such thing.

>e
Study
 A dark work room, its only lights eminate from the desktop compter and the small graphing desk. A large full legnth file cabinet rest in the corner. To the west is the Bedroom

>say I suck to the cabinet
You can only do that to something animate.