You slowly peel your eyes open to be met by the blinding midday light. The bones in your back crackle and pop as you attempt to sit up. It takes you a moment to orient yourself in this unfamiliar enviorment. It's time to find out what you've missed.

WakeyWakey
An Interactive Fiction by Riley Kam
Release 1 / Serial number 141003 / Inform 7 build 6L38 (I6/v6.33 lib 6/12N) SD

Bedroom
A nice comfy bedroom with a nice skylight sitting directly over the bed. A pile of dirty clothes lay clumped in a pile on the floor. A lone dresser with a mirror resides across from the bed. To the east is the Study. To the south is the kitchen.

You can see a velvet door here.

I beg your pardon?

>s
Study
 A dark work room, its only lights eminate from the desktop compter and the small graphing desk. A large full legnth file cabinet rest in the corner. To the north is the Bedroom

You can see a password here.

>n
Bedroom
A nice comfy bedroom with a nice skylight sitting directly over the bed. A pile of dirty clothes lay clumped in a pile on the floor. A lone dresser with a mirror resides across from the bed. To the south is the Study. To the east is the Kitchen.

>e
Kitchen
 What remains of this modest kitchen is what appears to be a war zone. It seems as though little Sally has went on a rampage. There is a large white freezer plugged in right next to the sink. What seems to be a kitchenware drawer is open. To the west is the Bedroom, to the east is Sally's Room.

>e
Sally's Room
The Room is reminescent of your sister's room back when you were kids. There is a large glass window framed above a small pink bed. The smell of rotten flesh eminates from the easy back oven. The Kitchen is west.

* * *

>take key
Taken.

>s
kitchen room
 What remains of this modest kitchen is what appears to be a war zone. It seems as though little Sally has went on a rampage. There is a large white freezer plugged in right next to the sink. What seems to be a kitchen ware drawer is open. To the North is the Bedroom, to the South is Sally's Room.  

You can see a Velvet Door here.

>open velvet door
It seems to be locked.

>use key to open velvet door
That's not a verb I recognise.

>use key]
That's not a verb I recognise.

>use key
That's not a verb I recognise.

>open door
It seems to be locked.

>use key
That's not a verb I recognise.

>i
You are carrying:
  a key

* * *

>e
Study
 A dark work room, its only lights eminate from the desktop compter and the small graphing desk. A large full legnth file cabinet rest in the corner. To the west is the Bedroom

You can see an I Suck here.

>open the file cabinet with I suck
(first taking the I Suck)
You unlock the file cabinet.

* * *

>e
Study
 A dark work room, its only lights eminate from the desktop compter and the small graphing desk. A large full legnth file cabinet rest in the corner. To the west is the Bedroom

You can see an I Suck here.

>w
Bedroom
A nice comfy bedroom with a nice skylight sitting directly over the bed. A pile of dirty clothes lay clumped in a pile on the floor. A lone dresser with a mirror resides across from the bed. To the south is the Study. To the east is the Kitchen.

>s
Study
 A dark work room, its only lights eminate from the desktop compter and the small graphing desk. A large full legnth file cabinet rest in the corner. To the north is the Bedroom

You can see a password here.

>e
You can't go that way.

* * *

>e
Study
 A dark work room, its only lights eminate from the desktop compter and the small graphing desk. A large full legnth file cabinet rest in the corner. To the west is the Bedroom

You can see an I Suck here.

>I suck
I only understood you as far as wanting to take inventory.

>I Suck
I only understood you as far as wanting to take inventory.

>i
You are carrying nothing.

* * *

>e
Study
 A dark work room, its only lights eminate from the desktop compter and the small graphing desk. A large full legnth file cabinet rest in the corner. To the west is the Bedroom

You can see an I Suck here.

>take I suck
Taken.

>open file cabinet with I suck
That doesn't seem to fit the lock.

* * *

>e
Study
 A dark work room, its only lights eminate from the desktop compter and the small graphing desk. A large full legnth file cabinet rest in the corner. To the west is the Bedroom

You can see an I Suck here.

>take password
That's hardly portable.

>x ntoe
You can't see any such thing.

>x note
 The note appears to be from your sister addressed to you. It reads, Hey Bro, I need you to watch my daughter Sally for a couple days while me and Jim are on our honeymoon. I know she'll probably drive you crazy but bear with it. Don't take sleep pills just to escape the stress of dealing with her. She's quite a lively one so if you leave her alone she may mess with you and our precious house. Thanks for the Solid and see you soon. -From, Ann P.S If you do pass out and are reading this message for the first time, (to your knowledge), then go to the file cabinet and use this password, password

>take password
That's hardly portable.

>open file cabinet with password
You unlock the file cabinet.

>open the file cabinet
You open the file cabinet, revealing a key.

>x key
 A iron key with a small velvet strip taped to the top.

>take key
Taken.

* * *

>open velvet door with key
You unlock the velvet door.

>s
(first opening the velvet door)

Kitchen room
 What remains of this modest kitchen is what appears to be a war zone. It seems as though little Sally has went on a rampage. There is a large white freezer plugged in right next to the sink. What seems to be a kitchenware drawer is open. To the North is the Bedroom, to the South is Sally's Room.  

You can see a velvet door here.

>s
Sally's Room
The Room is reminescent of your sister's room back when you were kids. There is a large glass window framed above a small pink bed. The smell of rotten flesh eminates from the easy back oven. The Kitchen is North and the Yard is towards the South.

>n
Kitchen room
 What remains of this modest kitchen is what appears to be a war zone. It seems as though little Sally has went on a rampage. There is a large white freezer plugged in right next to the sink. What seems to be a kitchenware drawer is open. To the North is the Bedroom, to the South is Sally's Room.  

You can see a velvet door here.

>n
Bedroom
A nice comfy bedroom with a nice skylight sitting directly over the bed. A pile of dirty clothes lay clumped in a pile on the floor. A lone dresser with a mirror resides across from the bed. To the east is the Study. To the south is the kitchen.

You can see a velvet door here.

>s
Kitchen room
 What remains of this modest kitchen is what appears to be a war zone. It seems as though little Sally has went on a rampage. There is a large white freezer plugged in right next to the sink. What seems to be a kitchenware drawer is open. To the North is the Bedroom, to the South is Sally's Room.  

You can see a velvet door here.

>s
Sally's Room
The Room is reminescent of your sister's room back when you were kids. There is a large glass window framed above a small pink bed. The smell of rotten flesh eminates from the easy back oven. The Kitchen is North and the Yard is towards the South.

* * *

>e
Study
 A dark work room, its only lights eminate from the desktop compter and the small graphing desk. A large full legnth file cabinet rest in the corner. To the west is the Bedroom

You can see an I Suck here.

>open file cabinet with password
(first taking the password)
That doesn't seem to fit the lock.

>i
You are carrying:
  a password

>open file cabinet with password
That doesn't seem to fit the lock.

* * *

>e
Study
 A dark work room, its only lights eminate from the desktop compter and the small graphing desk. A large full legnth file cabinet rest in the corner. To the west is the Bedroom

You can see an I Suck here.

>say I Suck
(to the file cabinet)
There is no reply.

* * *

>s
(first opening the velvet door)
It seems to be locked.

* * *

>open velvet door with key
You unlock the Velvet Door.

>n
(first opening the Velvet Door)

Bedroom room
You can see a Velvet Door here.

* * *

>s
(first opening the velvet door)
It seems to be locked.

>e
Study
 A dark work room, its only lights eminate from the desktop compter and the small graphing desk. A large full length file cabinet rest in the corner. To the west is the Bedroom

You can see an I Suck here.

>n
Bedroom
A nice comfy bedroom with a nice skylight sitting directly over the bed. A pile of dirty clothes lay clumped in a pile on the floor. A lone dresser with a mirror resides across from the bed. To the east is the Study. To the south is the Study.

>w
You can't go that way.

>e
Kitchen
 What remains of this modest kitchen is what appears to be a war zone. It seems as though little Sally has went on a rampage. There is a large white freezer plugged in right next to the sink. What seems to be a kitchenware drawer is open. To the west is the Bedroom, to the east is Sally's Room.

* * *

>e
Sally's Room
The Room is reminescent of your sister's room back when you were kids. There is a large glass window framed above a small pink bed. The smell of rotten flesh eminates from the easy back oven. The Kitchen is west.

>w
Kitchen
 What remains of this modest kitchen is what appears to be a war zone. It seems as though little Sally has went on a rampage. There is a large white freezer plugged in right next to the sink. What seems to be a kitchenware drawer is open. To the west is the Bedroom, to the east is Sally's Room.

>w
Bedroom
A nice comfy bedroom with a nice skylight sitting directly over the bed. A pile of dirty clothes lay clumped in a pile on the floor. A lone dresser with a mirror resides across from the bed. To the east is the Study. To the south is the Study.

>s
Study
 A dark work room, its only lights eminate from the desktop compter and the small graphing desk. A large full legnth file cabinet rest in the corner. To the north is the Bedroom

You can see a password here.

* * *

>e
Study
 A dark work room, its only lights eminate from the desktop compter and the small graphing desk. A large full length file cabinet rest in the corner. To the west is the Bedroom

You can see an I Suck here.

>take password
Taken.

* * *

>e
Study
 A dark work room, its only lights eminate from the desktop compter and the small graphing desk. A large full length file cabinet rest in the corner. To the west is the Bedroom

You can see an I Suck here.

>take I suck
Taken.

* * *

>e
Study
 A dark work room, its only lights eminate from the desktop compter and the small graphing desk. A large full length file cabinet rest in the corner. To the west is the Bedroom

You can see an I Suck here.

>take isuck
You can't see any such thing.

* * *

>s
(first opening the velvet door)
It seems to be locked.

>x velvet door
You can't see any such thing.